0000000000000000000000000000000000000000
6666200000000000000000000000000000000000
0000100000466666666666666666666666620000
0000100000100000000000000000000000010000
0000100000100000000000000000000000010000
0000100000366666666666666666666620010000
0000100000000000000000000000000010010000
0000320000000000000000000000000010010000
0000036666666666662000000000000010010000
0000000000000000001000046666666650010000
0000000000000000001000010000000000010000
0000466666666666665000010000000000010000
0000100000000000000000010004666666650000
0000100000000000000000010001000000000000
0000100000000000000000010001000000000000
0000100000000000000000010001000000000000
0000366666666666666200010001000466662000
0000000000000000000100010001000100001000
0000466666666666666500010001000100001000
0004500000000000000000010001000100001000
0001000000000000000000010003666500001000
0003666666666666666666650000000000003620
0000000000000000000000000000000000000010
0000000000000000000000000000000000000010